111111111111111111111111111111
1E0000000000000C00000C00100001
101001010010000010100100100001
101001001010101000100100100001
100000000C00C00000000000100001
1P0000000000000C00000C00100001
101001010010000010100100100001
101001001010101000100100100001
100000000C00C00000000000100001
111111111111111111111111111111
101001010010000010100100100001
101001001010101000100100100001
101001010010000010100100100001
101001001010101000100100100001
101001010010000010100100100001
111111111111111111111111111111
